height 26
width 16
3333333333333333
3000000000000003
3000000000000003
3001111000000003
3000000002222003
3001110022000053
3000000002000053
3000000002222003
3000000000000003
3000000000000003
3333333300044003
3000000000044003
3000333300000003
3000300000000003
3000300000000003
3111111111111003
3000000100000003
3000000100000003
3000000100001013
3000000100001003
3111000101101003
3000000100001003
3000000000001103
3000000000001003
3000000000001003
3333333333333333