height 24
width 30
111111111111111111111111111111
100000000000000001111111111111
100001111111100001100000000011
111001111111100001111110111111
111001111111100001111110111111
111001111111100000000000111111
111000000001111111111000111111
111000000000011111111000111111
111001110001111111100000111111
111000010000011111111100000111
111111111011111110000000110111
111111111011111100011111110111
111111111011100000000000110111
111100000011111111111000110111
111111100000000000000000110111
111011100011111111111000010111
111000000011111000000000000111
111100000011111111111100011111
111100000011111111000000011111
111100000011111111111111011111
111111111011111111000000011111
111111111011111111000111111111
111000000011111111000111111111
111111111111111111111111111111
